16,16,16,16,16,16,16,16,16,16,16,16,16,16,16,16,16,16,16,16,16,16,16,16,16
16,24,24,24,24,24,24,24,24,24,24,24,24,24,24,24,24,24,24,24,24,24,24,24,16
16,24,24,24,24,24,24,24,24,24,24,24,24,24,24,12,13,24,24,24,24,24,24,24,16
16,24,24,24,24,24,24,01,24,24,24,00,24,24,24,15,14,24,24,24,24,00,24,24,16
16,24,24,24,24,24,24,05,24,24,24,24,24,24,24,24,24,24,24,24,24,24,24,24,16
16,24,24,24,24,24,24,05,24,24,24,24,24,24,24,24,24,24,24,24,24,24,24,24,16
16,24,24,24,24,24,24,05,24,24,24,24,24,24,24,24,24,24,24,24,24,24,24,24,16
16,24,00,24,24,24,04,11,02,24,24,24,24,24,24,24,24,24,24,24,24,24,24,24,16
16,24,24,24,24,24,24,03,24,24,24,24,24,24,24,24,01,24,24,24,24,24,24,24,16
16,24,24,24,24,24,24,24,24,24,24,24,24,24,24,24,05,24,24,24,24,24,24,24,16
16,24,24,24,24,24,24,24,24,24,24,24,24,24,24,24,05,24,24,24,24,24,24,24,16
16,24,24,24,24,24,24,24,24,24,24,24,24,24,24,24,05,24,24,24,24,24,24,24,16
16,24,24,24,01,01,24,24,24,24,24,24,24,24,24,24,07,06,06,06,02,24,24,24,16
16,24,24,24,05,05,24,24,24,24,24,24,24,24,24,24,05,24,24,24,24,24,24,24,16
16,24,24,24,05,15,06,06,02,24,24,04,06,06,06,06,11,06,02,24,24,24,24,24,16
16,24,24,24,05,24,24,24,24,24,24,24,24,24,24,24,05,24,24,24,24,24,24,24,16
16,24,24,24,03,24,24,24,24,24,24,24,24,24,24,24,03,24,24,24,24,24,24,24,16
16,24,24,24,24,24,24,24,24,24,24,24,24,24,24,24,24,24,24,24,24,24,24,24,16
16,24,24,24,24,24,24,24,24,24,24,24,24,24,24,24,24,24,24,24,24,24,24,24,16
16,16,16,16,16,16,16,16,16,16,16,16,16,16,16,16,16,16,16,16,16,16,16,16,16

